NO textures/north_wall.xpm
SO textures/north_wall.xpm
WE textures/north_wall.xpm
EA textures/north_wall.xpm
F 255,0,0
C 0,0,255

111111111
11111011
10N0111
110101
111111