NO textures/north_brick.xpm
SO textures/south_brick.xpm
WE textures/west_brick.xpm
F 216,191,216
C 25,25,112

111111111111
101000010001
101000010001
101001110001
101000010001
100000010001
100000000001
111110000001
100010000001
110000000001
100N10000001
111111111111