NO textures/north_brick.xpm
SO textures/south_brick.xpm
WE textures/west_brick.xpm
EA textures/east_brick.xpm
F 216,191,216
C 25,25,112

111111111111
101000010001
101000010001
101001110001
101000010001
100000010001
100000000001
111110000001
100010000001
110000000001
100N10000001
111111111111

        1111111111111111111111111
        1000000000110000000000001
        1011000001110000000000001
        1001000000000000000000001
111111111011000001110000000000001
100000000011000001110111111111111
11110111111111011100000010001
11110111111111011101010010001
11000000110101011100000010001
10000000000000001100000010001
10000000000000001101010010001
11000001110101011111011110N0111
11110111 1110101 101111010001
11111111 1111111 111111111111