NO textures/north_brick.xpm
SO textures/south_brick.xpm
WE textures/west_brick.xpm
EA textures/east_brick.xpm
F 255,0,0
C 0,0,255


111111111
10000001
1000001
100001
111111