NO textures/north_rock.xpm
SO textures/south_rock.xpm
WE textures/west_rock.xpm
111111111111111111111111
100000000000000010000001
10100N000000000000000001
101000000000000000000001
101000000000000010000001
101000011111111111011111
101000010101010110001111
101000010000000110000001
111111111111111111111111
EA textures/east_rock.xpm
F 191,203,191
C 18,11,30