NO textures/north_wood.xpm
SO textures/south_wood.xpm
WE textures/west_wood.xpm
EA textures/east_wood.xpm
F 154,205,50
C 70,130,180

111111111111111111111111111111111111111111111111111111111111111111111111111111111111111111111111111111111111
100000000000110000000000001100000000000000001000000001100000000000110000000000001100000000000000001000000001
100000000000000000010000001100000000000000001000000001100000000000110000000000001100000000000000001000000001
100000000000000001000000001100000000000000000000000001100000000000110000000000001100000000000000001000000001
100000000000000001000000001100000000000000001000000001100000000000110000000000001100000000000000001000000001
100000000000000001000000000000000000000000001111111111100000000000110000000000001100000000000000001000000001
100000000000000001000000000000000000000000001000000001100000000000110000000000001100000000000000001000000001
100000000000000001000000001100000000000000000000000001100000000000110000000000001100000000000000001000000001
100000000000000001000000001100000000000000001000000001100000000000110000000000001100000000000000001000000001
100000000000000001000000001100000000000000001000000001100000000000110000000000001100000000000000001000000001
100000000000000001000000000000000000000000001111001111100000000000110000000000001100000000000000001000000001
100000000000000001000000000000000000000000001000000001100000000000110000000000001100000000000000001000001111
100000000000000010000000001100000000000000001000000001100000000000110000000000001100000000000000001000001
100000000000000100000110111100000000000000001000000001100000000000110000000000001100000000000000001000001
111000011111111111110000111100000000000000001000000001100000000000110000000000001100000000000000001000001
111110000001111100000011111100000000000000001000000001100000000000110000000000001100000000000000001000001
100001110000110000011100001100000000000000001111001111100000000000110000000000001100000000000000001000001111
100000000000000000010000001100000000000000001000000001100000000000110000000000001100000000000000001000000001
100000000000000001000000001100000000000000001000000001100000000000110000000000001100000000000000001000000001
100000000000000001000000001100000000000000001000000001100000000000110000000000001100000000000000001000000001
100000000000000001000000001100000000000000001001111001100000000000110000000000001100000000000000001000000001
100001000001000001000000001100000000000000001000000001111110000000110000000000001100000000000000001000000001
1000001000100000010000000011000000000000000010000000011   10000000110000000000001100000000000000001000000001
1000000101000000010000000011000000000000000000000000011   10000000110000000000001100000000000000001000000001
1000000010000000010000000011000000000000000010000000011   10000000110000000000001100000000000000001000000001
1000000101000000010000000011000000000000000010000000011   10000000110000000000001100000000000000001000000001
1000001000100000010000000011000000000000000000000000011   10000000110000000000001100000000000000001000000001
1000010000010000100000000011000000000000000010000000011   10000000110000000000001100000000000000001000000001
100000000N000001000001101111000000000000000010000000011   10000000110000000000001100000000000000001000000001
1111111111111111111111111111111111111111111111111111111   11111111111111111111111111111111111111111111111111