NO textures/north_rocktile.xpm
SO textures/south_rocktile.xpm
WE textures/west_rocktile.xpm
EA textures/east_rocktile.xpm
F 255,204,153
C 41,24,0

111111111111111111111111111
100000000000110000000000001
100000000000000000010000001
100111111100111111000000001
100000000000000001000000001
100000010000000001111111001
100100010000000001000000001
100100010011111111000000001
100100010000000001000000001
100100010000000001000000001
100100011111111001000111101
100100010000000001000100001
100100010000000010000100001
100000010N00000100000100111
111111111111111111111111111
