NO textures/north_wood.xpm
SO textures/south_wood.xpm
WE textures/west_wood.xpm
EA textures/east_wood.xpm
F 255,0,0
C 0,0,255

111111111111111111111111111111111111111111111111111111
100000000000110000000000001100000000000000001000000001
100000000000000000010000001100000000000000001000000001
100000000000000001000000001100000000000000000000000001
100000000000000001000000001100000000000000001000000001
100000000000000001000000000000000000000000001111111111
100000000000000001000000000000000000000000001000000001
100000000000000001000000001100000000000000000000000001
100000000000000001000000001100000000000000001000000001
100000000000000001000000001100000000000000001000000001
100000000000000001000000000000000000000000001111001111
100000000000000001000000000000000000000000001000000001
100000000000000010000000001100000000000000001000000001
100000000000000100000110111100000000000000001000000001
111000011111111111110000111100000000000000001000000001
111110000001111100000011111100000000000000001000000001
100001110000110000011100001100000000000000001111001111
100000000000000000010000001100000000000000001000000001
100000000000000001000000001100000000000000001000000001
100000000000000001000000001100000000000000001000000001
100000000000000001000000001100000000000000001001111001
100001000001000001000000001100000000000000001000000001
100000100010000001000000001100000000000000001000000001
100000010100000001000000001100000000000000000000000001
100000001000000001000000001100000000000000001000000001
100000010100000001000000001100000000000000001000000001
100000100010000001000000001100000000000000000000000001
100001000001000010000000001100000000000000001000000001
100000000N00000100000110111100000000000000001000000001
111111111111111111111111111111111111111111111111111111